........................................................................................................................................................................................................
.                                              ..                                                  ..                                              ..                                                  .
.                                              ..                          ..                      ..                                              ..                          ..                      .
.                                              ..                          ..                      ..                                              ..                          ..                      .
.      ..............                          ..                  ...     ..                      ..      ..............                          ..                  ...     ..                      .
.            .............                     ..                  ...     ..   .....................            .............                     ..                  ...     ..   ....................
.                                              ..                  ...     ..   .....................                                              ..                  ...     ..   ....................
.       ....  .   .  .  .....                 .                                 ...     ..         ..       ....  .   .  .  .....                 .                                 ...     ..         .
.       .  .  .. ..  .    .            .. ..                        .........   ...     ..         ..       .  .  .. ..  .    .            .. ..                        .........   ...     ..         .
.       ....  . . .  .    .            .. ..                       .........    ...     ..         ..       ....  . . .  .    .            .. ..                       .........    ...     ..         .
.       ..    .   .  .    .            .. ..                 .         .        ...     ..         ..       ..    .   .  .    .            .. ..                 .         .        ...     ..         .
.       . .   .   .  .    .        .   .. ..                 .         ..                       .....       . .   .   .  .    .        .   .. ..                 .         ..                       ....
.       .  .  .   .  .    .        . . .. ..                 .         ..                       .....       .  .  .   .  .    .        . . .. ..                 .         ..                       ....
.                                  .                         .         ..  ..           .......    ..                                  .                         .         ..  ..           .......    .
.                                . .                         .         ..  ..           .......    ..                                . .                         .         ..  ..           .......    .
.                                . .                         .         ..  ..           .......                                      . .                         .         ..  ..           .......    .
.                                . .                         .         ..  ..           .......                                      . .                         .         ..  ..           .......    .
.                                . .      ....................         ..  ..           .......    ..                                . .      ....................         ..  ..           .......    .
.                                . .                         .         ..  ..           .......    ..                                . .                         .         ..  ..           .......    .
.                                . .      ....................         ..  ..           .......    ..                                . .      ....................         ..  ..           .......    .
.                                . .                                   ..  ..           .......    ..                                . .                                   ..  ..           .......    .
.                                ...                                   ..  ..           .......    ..                                ...                                   ..  ..           .......    .
.                                                                          ..       .........      ..                                                                          ..       .........      .
.      .            .           .            .                             ..       .                      .            .           .            .                             ..       .              .
.      .     .      .           .            .                             ..       .                      .     .      .           .            .                             ..       .              .
.      .     .      .                        .        .                    ..       .                      .     .      .                        .        .                    ..       .              .
.      .     .      .                        .        .                    ..       .                      .     .      .                        .        .                    ..       .              .
.      .     .      .           .            .        .                    ..                      ..      .     .      .           .            .        .                    ..                      .
.            .                  .                     .                    ..                      ..            .                  .                     .                    ..                      .
.                                . .                         .         ..  ..           .......    ..                                . .                         .         ..  ..           .......    .
.                                . .                         .         ..  ..           .......    ..                                . .                         .         ..  ..           .......    .
.                                . .      ....................         ..  ..           .......    ..                                . .      ....................         ..  ..           .......    .
.                                . .                         .         ..  ..           .......    ..                                . .                         .    X    ..  ..           .......    .
.                                . .      ....................         ..  ..           .......    ..                                . .      ....................         ..  ..           .......    .
.                                . .                         .         ..  ..           .......    ..                                . .                         .         ..  ..           .......    .
.                                . .                         .         ..  ..           .......    ..                                . .                         .         ..  ..           .......    .
.                                . .      ....................         ..  ..           .......    ..                                . .      ....................         ..  ..           .......    .
.                                . .                         .         ..  ..           .......    ..                                . .                         .         ..  ..           .......    .
.                                . .      ....................         ..  ..           .......    ..                                . .      ....................         ..  ..           .......    .
........................................................................................................................................................................................................
