....................................................................................................
.                                              ..                                                  .
.                                              ..                          ..                      .
.                                              ..                          ..                      .
.      ..............                          ..                  ...     ..                      .
.            .............                     ..                  ...     ..   ....................
.                                              ..                  ...     ..   ....................
.       ....  .   .  .  .....                 .                                 ...     ..         .
.       .  .  .. ..  .    .            .. ..                        .........   ...     ..         .
.       ....  . . .  .    .            .. ..                       .........    ...     ..         .
.       ..    .   .  .    .            .. ..                 .         .        ...     ..         .
.       . .   .   .  .    .        .   .. ..                 .         ..                       ....
.       .  .  .   .  .    .        . . .. ..                 .         ..                       ....
.                                  .                         .         ..  ..           .......    .
.                                . .                         .         ..  ..           .......    .
.                                . .                         .         ..  ..           .......    .
.                                . .                         .         ..  ..           .......    .
.                                . .      ....................         ..  ..           .......    .
.                                . .                         .         ..  ..           .......    .
.                                . .      ....................         ..  ..           .......    .
.                                . .                                   ..  ..           .......    .
.                                ...                                   ..  ..           .......    .
.                                                                          ..       .........      .
.      .            .           .            .                             ..       .              .
.      .     .      .           .            .                             ..       .              .
.      .     .      .                        .        .                    ..       .              .
.      .     .      .                        .        .                    ..       .              .
.      .     .      .           .            .        .                    ..                      .
.            .                  .                     .                  X ..                      .
....................................................................................................