........................................................................................................................................................................................................
.                                              ..                                                                                                                                                      .
.                                              ..                          ..                                                                                                                          .
.                                              ..                          ..                                                                                                                          .
.      ..............                          ..                  ...     ..                                                                                                                          .
.            .............                     ..                  ...     ..   ....................                                                                                                   .
.                                              ..                  ...     ..   .....................      .     .                               .        .                    ..                      .
.       ....  .   .  .  .....                                                   ...     ..         ..      .     .      .                        .        .                    ..                      .
.       .  .  .. ..  .    .            ........                     .........   ...     ..         ..      .     .      .                        .        .                    ..                      .
.       ....  . . .  .    .            ........                    .........    ...     ..         ..      .     .      .                        .        .                    ..                      .
.       ..    .   .  .    .            ........                                 ...     ..         ..      .     .      .                        .        .                    ..                      .
.       . .   .   .  .    .        .   ........                        ..                       .....      .     .      .                        .        .                    ..                      .
.       .  .  .   .  .    .        .   ........                        ..                       .....      .     .      .                        .        .                    ..                      .
.                                  .                                   ..  ..           .......    ..      .     .      .                        .        .                    ..                      .
.    ..       ..    ..       ..    .        ..      ..    ...          ..  ..           .......    ..      .     .      .                        .        .                    ..                      .
.    ....     ..    ....     ..    .        ..      ..    .....        ..  ..                      ..      .     .      .                        .        .                    ..                      .
.    .. ..    ..    .. ..    ..        .    ..      ..    ..  ...  ..      ..                      ..      .     .      .                        .        .                    ..                      .
.    ..  ..   ..    ..  ..   ..   .......   ..........    ..   ..  ..      ..                      ..      .     .      .        X               .        .                    ..                      .
.    ..   ..  ..    ..   ..  ..   .......   ..........    ..   ..  ..      ..                      ..      .     .      .                        .        .                    ..                      .
.    ..    .. ..    ..    .. ..        .    ..      ..    ..  ...          ..                      ..      .     .      .                        .        .                    ..                      .
.    ..     ....    ..     ....             ..      ..    .....            ..    ..........        ..      .     .      .                        .        .                    ..                      .
.    ..       ..    ..       ..             ..      ..    ...              ..    ..........        ..      .     .      .                        .        .                    ..                      .
.                                                                          ..                      ..      .     .      .                        .        .                    ..                      .
.      .            .           .            .                             ..                      ..      .     .      .                        .        .                    ..                      .
.      .     .      .           .            .                             ..                      ..      .     .      .                        .        .                    ..                      .
.      .     .      .                        .        .                    ..                      ..      .     .      .                        .        .                    ..                      .
.      .     .      .                        .        .                    ..                      ..      .     .      .                        .        .                    ..                      .
.      .     .      .           .            .        .                    ..                      ..      .     .      .                        .        .                    ..                      .
.            .                  .                     .                    ..                      ..      .     .      .                        .        .                    ..                      .
........................................................................................................................................................................................................
