...............
.        .    .
. X      .    .
.             .
...............
